1111111111111111111111111111111111111111
1P000000000000000000000000000000000000E1
10111111111111111111111111111111111111C1
1000000000000000000000000000000000000001
10111111111111111111111111111111111111C1
1000000000000000000000000000000000000C01
10111111111111111111111111111111111111C1
1000000000000000000000000000000000000001
10111111111111111111111111111111111111C1
1000000000000000000000000000000000000C01
1111111111111111111111111111111111111111
